WWWWWWWWWWWWWWWWWWWWWWWW
WWWWWWWWWWWSSWWWWWWWWWWW
WWWWWWWWWWWSSWWWWWWWWWWW
WWWWWWWWWWWSSWWWWWWWWWWW
WWWWWWWWWWMMMMWWWWWWWWWW
WWWWWWWWWMMMMMMWWWWWWWWW
WWWWWWWWMMMMMMMMWWWWWWWW
WWWWWEEEMMMMMMMMWWWWWWWW
WWWWWEEEMMMMMMMMWWWWWWWW
WWWWWWWWMMMMMMMMWWWWWWWW
WWWWWWWWWMMMMMMWWWWWWWWW
WWWWWWWWWWMMMMWWWWWWWWWW
WWWWWWWWWWWWWWWWWWWWWWWW
WWWWWWWWWWWWWWWWWWWWWWWW
OR,12.5,8.5,12.5,8.5,0.00,0,0
OR,12.5,8,12.5,8.5,0.00,0,0
OR,12.5,7.5,12.5,8.5,0.00,0,0
OR,12.5,7,12.5,8.5,0.00,0,0
OR,12.5,6.5,12.5,8.5,0.00,0,0
OR,12.5,6,12.5,8.5,0.00,0,0
OR,12.5,5.5,12.5,8.5,0.00,0,0
OR,12.5,5,12.5,8.5,0.00,0,0
C,12.5,5.5
C,15.5,8.5
C,12.5,11.5