WWWWWWWWWWWWWWWWWWWWWW
WWWWWWWWWWWWWWWWWWWWWW
WWWWWWWWWWWWWWWWWWWWWW
WWWWWWWWWWWWWWWWWWWWWW
WWSSSWWWWWWWWWWMMEEEWW
WWSSSWMMMMMMMMMMWEEEWW
WWSSSWMMMMMMMMMMWEEEWW
WWSSSWMMMMMMMMMMWEEEWW
WWSSSWMMMMMMMMMMWEEEWW
WWSSSMMWWWWWWWWWWEEEWW
WWWWWWWWWWWWWWWWWWWWWW
WWWWWWWWWWWWWWWWWWWWWW
WWWWWWWWWWWWWWWWWWWWWW
WWWWWWWWWWWWWWWWWWWWWW

16 | 6 | 6 | 6 | 5 | 0
6 | 7 | 16 | 7 | 5 | 0
16 | 8 | 6 | 8 | 5 | 0
6 | 9 | 16 | 9 | 5 | 0