WWWWWWWWWWWWWWWWWWWWWWWW
WWWWWWWWWWWWWWWWWWWWWWWW
WWWWWWWWWWWWWWWWWWWWWWWW
WWWWWWWWWWWWWWWWWWWWWWWW
WWWSSSWWWWWWWWWWMMEEEWWW
WWWSSSWMMMMMMMMMMWEEEWWW
WWWSSSWMMMMMMMMMMWEEEWWW
WWWSSSWMMMMMMMMMMWEEEWWW
WWWSSSWMMMMMMMMMMWEEEWWW
WWWSSSMMWWWWWWWWWWEEEWWW
WWWWWWWWWWWWWWWWWWWWWWWW
WWWWWWWWWWWWWWWWWWWWWWWW
WWWWWWWWWWWWWWWWWWWWWWWW
WWWWWWWWWWWWWWWWWWWWWWWW

17,6,8,6,-5,0
8,7,17,7,5,0
17,8,8,8,-5,0
8,9,17,9,5,0