WWWWWWWWWWWWWWWWWWWWWWWW
WMMMMMMMMMMMMMMMMMMMMMMW
WMMMMMMMMMMMMMMMMMMMMMMW
WMMMMMMMMMMMMMMMMMMMMMMW
WMMMMMMMMMMMMMMMMMMMMMMW
WMMMMMMMMMMMMMMMMMMMMMMW
WMMMMMMMMMSSMMMMMMMMMMMW
WMMMMMMMMMSSMMMMMMMMMMMW
WMMMMMMMMMMMMMMMMMMMMMMW
WMMMMMMMMMMMMMMMMMMMMMMW
WMMMMMMMMMMMMMMMMMMMMMMW
WMMMMMMMMMEEMMMMMMMMMMMW
WMMMMMMMMMEEMMMMMMMMMMMW
WWWWWWWWWWWWWWWWWWWWWWWW
C,10,5