WWWWWWWWWWWWWWWWWWWWWWWW
WWWWWWWWWWWWWWWWWWWWWWWW
WWWWWWWWWWWWWWWWWWWWWWWW
WWWWWWWWWWWWWWWWWWWWWWWW
WWWWWWMMMMMMMMMMMMWWWWWW
WWWWWWMMMMMMMMMMMMWWWWWW
WWWSSSMMMMMMMMMMMMEEEWWW
WWWSSSMMMMMMMMMMMMEEEWWW
WWWWWWMMMMMMMMMMMMWWWWWW
WWWWWWMMMMMMMMMMMMWWWWWW
WWWWWWWWWWWWWWWWWWWWWWWW
WWWWWWWWWWWWWWWWWWWWWWWW
WWWWWWWWWWWWWWWWWWWWWWWW
WWWWWWWWWWWWWWWWWWWWWWWW

7,5,7,10,0,2.5
9,5,9,10,0,2.5
11,5,11,10,0,2.5
13,5,13,10,0,2.5
15,5,15,10,0,2.5
17,5,17,10,0,2.5

8,10,8,5,0,-2.5
10,10,10,5,0,-2.5
12,10,12,5,0,-2.5
14,10,14,5,0,-2.5
16,10,16,5,0,-2.5
18,10,18,5,0,-2.5