WWWWWWWWWWWWWWWWWWWWWW
WWWWWWWWWWWWWWWWWWWWWW
WWWWWWWWWWWWWWWWWWWWWW
WWWWWWWWWWWWWWWWWWWWWW
WWSSSWWWWWWWWWWMMEEEWW
WWSSSWMMMMMMMMMMWEEEWW
WWSSSWMMMMMMMMMMWEEEWW
WWSSSWMMMMMMMMMMWEEEWW
WWSSSWMMMMMMMMMMWEEEWW
WWSSSMMWWWWWWWWWWEEEWW
WWWWWWWWWWWWWWWWWWWWWW
WWWWWWWWWWWWWWWWWWWWWW
WWWWWWWWWWWWWWWWWWWWWW
WWWWWWWWWWWWWWWWWWWWWW
OS,16,6,-5,0,0,7,6,5,0,0
OS,7,7,5,0,0,16,7,-5,0,0
OS,16,8,-5,0,0,7,8,5,0,0
OS,7,9,5,0,0,16,9,-5,0,0