WWWWWWWWWWWWWWWWWWWWWWWW
WMMMMMMMMMMMMMMMMMMMMMMW
WMMMMMMMMMMMMMMMMMMMMMMW
WMMMMMMMMMMMMWMMWMMMMMMW
WMMMMMMMMMMMMMEEMMMMMMMW
WMMMMMMMMMMMMMEEMMMMMMMW
WMMMMMMMMMMMMWMMWMMMMMMW
WMMMMMMMMMMMMMMMMMMMMMMW
WMMMMMMMMMMMMMMMMMMMMMMW
WMMMMMMMMMMMMMMMMMMMMMMW
WMMWSSWMMMMMMMMMMMMMMMMW
WMMWSSWMMMMMMMMMMMMMMMMW
WMMWWWWMMMMMMMMMMMMMMMMW
WWWWWWWWWWWWWWWWWWWWWWWW
O,10,10,0,0
C,12.5,7.5
S,4,4,2,2
S,14,10,2,2