WWWWWWWWWWWWWWWWWWWWWWWW
WWWWWWWWWWWWWWWWWWWWWWWW
WWWWWWWWWWWWWWWWWWWWWWWW
WWWWWWWWWWWWWWWWWWWWWWWW
WWWSSSWWWWWWWWWWMMEEEWWW
WWWSSSWMMMMMMMMMMWEEEWWW
WWWSSSWMMMMMMMMMMWEEEWWW
WWWSSSWMMMMMMMMMMWEEEWWW
WWWSSSWMMMMMMMMMMWEEEWWW
WWWSSSMMWWWWWWWWWWEEEWWW
WWWWWWWWWWWWWWWWWWWWWWWW
WWWWWWWWWWWWWWWWWWWWWWWW
WWWWWWWWWWWWWWWWWWWWWWWW
WWWWWWWWWWWWWWWWWWWWWWWW
OS,17,6,-5,0,0,8,6,5,0,0
OS,8,7,5,0,0,17,7,-5,0,0
OS,17,8,-5,0,0,8,8,5,0,0
OS,8,9,5,0,0,17,9,-5,0,0