WWWWWWWWWWWWWWWWWWWWWWWW
WWWWWWWWWWWWWWWWWWWWWWWW
WWWWWWWWWWWWWWWWWWWWWWWW
WWWWWWWWWWWWWWWWWWWWWWWW
WWWWWWMMMMMMMMMMMMWWWWWW
WWWWWWMMMMMMMMMMMMWWWWWW
WWWSSSMMMMMMMMMMMMEEEWWW
WWWSSSMMMMMMMMMMMMEEEWWW
WWWWWWMMMMMMMMMMMMWWWWWW
WWWWWWMMMMMMMMMMMMWWWWWW
WWWWWWWWWWWWWWWWWWWWWWWW
WWWWWWWWWWWWWWWWWWWWWWWW
WWWWWWWWWWWWWWWWWWWWWWWW
WWWWWWWWWWWWWWWWWWWWWWWW
O,7,5,7,10,0,2.5
O,9,5,9,10,0,2.5
O,11,5,11,10,0,2.5
O,13,5,13,10,0,2.5
O,15,5,15,10,0,2.5
O,17,5,17,10,0,2.5
O,8,10,8,5,0,-2.5
O,10,10,10,5,0,-2.5
O,12,10,12,5,0,-2.5
O,14,10,14,5,0,-2.5
O,16,10,16,5,0,-2.5
O,18,10,18,5,0,-2.5
C,12.5,7.5


