WWWWWWWWWWWWWWWWWWWWWWWW
WWWWWWWWWWWWWWWWWWWWWWWW
WWWWWWWWWWWWWWWWWWWWWWWW
WWWWWWWWWWWWWWWWWWWWWWWW
WWWWWWWWWWWWWWWWWWWWWWWW
WWWWWWWWEEEEEEEWWWWWWWWW
WWWWWWWWEMMMMMEWWWWWWWWW
WWWWWWWWEMSSSMEWWWWWWWWW
WWWWWWWWEMSSSMEWWWWWWWWW
WWWWWWWWEMMMMMEWWWWWWWWW
WWWWWWWWEEEEEEEWWWWWWWWW
WWWWWWWWWWWWWWWWWWWWWWWW
WWWWWWWWWWWWWWWWWWWWWWWW
WWWWWWWWWWWWWWWWWWWWWWWW

O,17,6,8,6,-5,0
O,8,7,17,7,5,0
O,17,8,8,8,-5,0
O,8,9,17,9,5,0